############################X###
############################X###
##########################....##
###################.....##....##
##............................##
##.##########...###.....##....##
##.......####.................##
##........###...   .....########
##........###.#####.....########
##........###.#####.....########
##.##.###.###.#####.....########
##.##.###.###.#####.....########
##.##.##....#.#######..#########
##.##.##....#.#######..#####...#
##.##.##....#....####..#####...#
#.....##....#....####..........#
#.....##.......................#
#.....##....#D#######.....##...#
#.....##....#.#######.....######
#.....##....#.#######.....######
##.##.##....#.#######.....######
##.##.#######.#######.....######
##.##.#######.#######.....######
#........####.#######.....######
#........####.#######.....######
#........###...#######..########
#........###...#######..########
#........###...#######..########
#........###...####........#####
#........###...####........#####
#........###...####........#####
######################@#########
