################################
#                              #
#                              #
#                        ....  #
#                       ...... #
#                 ..    ...E.. #
#                 ..    ...... #
#              .....   ........X
#             ................ #
#             ................ #
#        ..  .......     ..... #
#       ............     ..... #
#       ............    .....  #
#        ...........    .....  #
#         .........     .....  #
#         .........      ..... #
# ..     ..........       .... #
#..............   ..       ..  #
#.............     ..          #
#.............     ...         #
#..............   .....        #
#.......................       #
#.......................       #
# ..    ....@..........        #
#        .............         #
#         .....   ...          #
#                              #
#                              #
#                              #
#                              #
#                              #
################################
