########################X#######
#        .....        .....    #
#        .. ..        ......   #
#        .  .. .       ..E..   #
#       ...... .....   .....   #
#        ............. .....   #
#       ................ .... .#
#         ..E..................#
#         ........... .... ....#
#         ............. .......#
#         .........  .  ...... #
#        ..........  .....  ...#
#      ..................  . ..#
#     ..........  .............#
#     ...   ........   ........#
#    ..........................#
#..  ............ .   ....... .#
#.... ...  ........   .........#
#... ........ ....  ...........#
#... .......  .................#
#...........  ...  .........  .#
#... ........ ... ..........   #
#. .........................   #
#   .... ......... ........    #
#      ......................  #
#     ......................   #
#     ........................ #
#     ......... .......... ....#
#      ........................#
#        ................... . #
#         ....  ....@......... #
################################
